##########
#P#      #
# # ######
# * #    #
### #X####
#   # *  #
# ### ## #
# X    #E#
#     *# #
##########