##########
#P#  X#* #
# # # # ##
# * # # X#
### # ####
# # # # E#
# # ###* #
# # #    #
#   #### #
##########