##########
#P *  # X#
#### ## ##
#  # # * #
# ## # # #
# #  # #E#
# # ## ###
#*# X    #
# ### ####
##########