##########
#P *     #
# ### ####
# #   *  #
# #X######
#     # ##
#### #*# #
#E     # #
#   #    #
##########