##########
# # E#   #
# # X## ##
# # #*   #
#   #  # #
## ## P# #
# * # X# #
# ### ## #
#X   *   #
##########